Startmap2
[BACKTILES]
45 45 45 45 45 4 1 9 2 18 2 64 2 18 2 3 1 8 45 45 45 45 45 45 45  
45 45 45 45 45 4 1 8 15 27 32 32 32 31 15 4 1 8 45 45 45 45 45 45 45  
45 45 45 45 45 4 1 16 0 29 34 24 34 30 0 17 1 8 45 45 45 45 45 45 45  
45 45 45 45 45 4 1 8 0 28 33 24 37 26 0 4 1 8 45 68 69 45 45 45 45  
45 45 45 45 45 4 1 21 0 0 29 24 30 0 0 4 1 8 45 70 71 45 45 45 45  
45 45 45 45 45 4 1 16 0 38 28 25 26 0 0 17 1 8 45 14 72 45 45 45 45  
45 45 68 69 45 4 1 8 0 0 0 0 0 0 0 4 1 8 45 45 45 45 45 45 45  
45 45 70 71 45 4 1 7 6 6 11 0 10 6 6 5 1 8 45 45 45 45 45 45 45  
45 45 14 72 45 4 1 1 1 1 16 0 17 1 1 1 1 8 45 45 68 69 45 45 45  
45 45 45 45 45 13 2 2 2 2 12 0 13 2 2 2 2 12 45 45 70 71 45 45 45  
45 45 45 45 45 45 45 40 45 45 45 63 62 39 45 45 45 45 45 45 14 72 45 45 45  
45 45 48 45 45 45 45 45 45 45 45 63 45 45 45 45 45 45 43 47 57 45 60 45 45  
45 45 45 45 45 45 45 45 45 45 45 63 45 45 45 45 45 45 50 48 52 45 61 45 45  
58 58 58 58 58 58 58 58 58 58 58 59 45 45 45 68 69 45 41 47 39 45 45 45 45  
45 45 45 45 45 45 45 45 45 45 45 45 45 45 45 70 71 45 45 45 45 45 45 45 45
45 45 45 42 45 45 45 45 45 46 60 45 45 45 45 14 72 45 45 45 45 68 69 45 45
45 45 45 48 45 45 68 69 45 50 61 53 45 45 45 45 45 45 45 45 45 70 71 45 45
45 45 45 45 45 45 70 71 45 43 51 40 45 45 45 45 45 45 45 45 45 14 72 45 45
45 45 45 45 45 45 14 72 45 45 45 45 45 45 45 45 45 45 45 45 45 45 45 45 45  
45 45 45 45 45 45 45 45 45 45 45 45 45 45 45 45 45 45 45 45 45 45 45 45 45
[BLOCKTILES]
1 1 1 1 1 1 1 1 1 1 1 1 1 1 1 1 1 1 1 1 1 1 1 1 1  
1 0 0 0 0 1 1 1 1 0 0 0 0 0 1 1 1 1 0 0 0 0 0 0 1  
1 0 0 0 0 1 1 1 0 0 1 0 1 0 0 1 1 1 0 0 0 0 0 0 1  
1 0 0 0 0 1 1 1 0 0 0 0 0 0 0 1 1 1 0 1 1 0 0 0 1  
1 0 0 0 0 1 1 1 0 0 0 0 0 0 0 1 1 1 0 1 1 0 0 0 1  
1 0 0 0 0 1 1 1 0 1 0 0 0 0 0 1 1 1 0 0 0 0 0 0 1  
1 0 1 1 0 1 1 1 0 0 0 0 0 0 0 1 1 1 0 0 0 0 0 0 1  
1 0 1 1 0 1 1 1 1 1 1 0 1 1 1 1 1 1 0 0 0 0 0 0 1  
1 0 0 0 0 1 1 1 1 1 1 0 1 1 1 1 1 1 0 0 1 1 0 0 1  
1 0 0 0 0 1 1 1 1 1 1 0 1 1 1 1 1 1 0 0 1 1 0 0 1  
1 0 0 0 0 0 0 0 0 0 0 0 0 0 0 0 0 0 0 0 0 0 0 0 1  
1 0 1 0 0 0 0 0 0 0 0 0 0 0 0 0 0 0 0 0 0 0 1 0 1  
1 0 0 0 0 0 0 0 0 0 0 0 0 0 0 0 0 0 0 0 0 0 0 0 1  
0 0 0 0 0 0 0 0 0 0 0 0 0 0 0 1 1 0 0 0 0 0 0 0 1  
1 0 0 0 0 0 0 0 0 0 0 0 0 0 0 1 1 0 0 0 0 0 0 0 1  
1 0 0 0 0 0 0 0 0 0 1 0 0 0 0 0 0 0 0 0 0 1 1 0 1  
1 0 0 1 0 0 0 0 0 0 0 0 0 0 0 0 0 0 0 0 0 1 1 0 1
1 0 0 0 0 0 0 0 0 0 0 0 0 0 0 0 0 0 0 0 0 0 0 0 1  
1 0 0 0 0 0 0 0 0 0 0 0 0 0 0 0 0 0 0 0 0 0 0 0 1  
1 1 1 1 1 1 1 1 1 1 1 1 1 1 1 1 1 1 1 1 1 1 1 1 1
[NEIGHBOURS]
1 1 1 1
[ENEMIES]
370 150 BlueGuard
585 150 BlueGuard
[SHOPNPC]
330 150 ShopNPC
[CIVILIAN]
100 100 Quester
[ITEMS]



