MAPHEJSAn
[BACKTILES]
45 222 148 148 148 233 45 45 45 45 45 45 63 45 235 239 45 45 45 224 45 45 45 235 45  
239 222 148 132 133 39 251 252 253 235 239 45 63 46 48 52 45 68 69 224 45 46 50 48 239  
45 222 148 134 135 45 257 258 259 48 51 45 63 45 244 238 45 70 71 224 45 46 51 52 47  
45 222 236 136 137 45 260 261 262 47 47 45 63 45 45 45 45 14 72 224 45 45 52 47 45  
45 222 45 45 45 45 45 154 45 45 45 45 63 45 139 140 141 45 45 224 45 45 45 45 235  
45 226 218 82 45 45 45 153 58 58 159 58 231 45 142 143 144 45 45 220 228 40 39 45 45  
45 239 226 218 82 45 45 45 45 45 63 148 148 247 145 146 147 45 45 243 220 228 45 57 45  
45 45 41 226 218 45 90 90 45 45 63 160 148 39 45 154 45 45 45 243 236 224 45 56 45  
45 45 45 45 226 221 221 221 218 45 153 58 159 58 58 59 45 45 263 264 45 224 45 45 45  
227 223 223 223 228 45 236 45 226 218 45 45 63 45 45 45 45 45 265 266 45 224 45 235 45  
222 87 88 86 220 228 45 263 264 222 44 45 63 45 45 46 51 51 267 268 45 224 45 45 45  
222 83 84 85 82 220 228 265 266 222 48 57 63 45 46 51 160 52 239 45 45 224 45 45 45  
222 39 239 243 148 148 224 267 268 222 239 45 63 45 45 52 52 51 45 45 45 224 45 68 69  
222 45 154 42 48 148 224 202 227 219 45 45 63 45 99 45 47 244 45 232 217 225 45 70 71  
222 247 63 243 236 233 220 223 219 233 229 58 231 45 45 45 45 45 45 217 225 45 45 14 72  
222 247 153 58 58 155 156 45 45 45 63 45 45 217 221 221 221 221 221 225 45 45 45 237 45  
226 218 40 45 45 157 158 58 58 58 59 45 217 225 148 247 45 45 45 45 45 45 45 235 45  
45 226 218 45 45 239 45 45 45 45 45 217 225 148 233 45 91 45 68 69 45 100 89 45 45  
45 237 226 221 221 221 221 221 221 221 221 225 243 236 239 45 45 91 70 71 45 45 45 45 232  
45 45 45 45 239 45 45 45 45 237 45 45 45 45 45 45 45 45 14 72 45 235 45 45 45  
[BLOCKTILES]
0 1 0 0 0 0 0 0 0 0 0 0 0 0 0 0 0 0 0 1 0 0 0 0 0  
0 1 0 1 1 0 1 1 1 0 0 0 0 0 1 0 0 1 1 1 0 0 0 1 0  
0 1 0 1 1 0 1 1 1 1 0 0 0 0 0 0 0 1 1 1 0 0 0 0 0  
0 1 0 0 0 0 1 0 1 0 0 0 0 0 0 0 0 0 0 1 0 0 0 0 0  
0 1 0 0 0 0 0 0 0 0 0 0 0 0 1 1 1 0 0 1 0 0 0 0 0  
0 1 1 1 0 0 0 0 0 0 0 0 0 0 1 1 1 0 0 1 1 0 0 0 0  
0 0 1 1 1 0 0 0 0 0 0 0 0 0 1 0 1 0 0 0 1 1 0 0 0  
0 0 0 1 1 0 1 1 0 0 0 1 0 0 0 0 0 0 0 0 0 1 0 0 0  
0 0 0 0 1 1 1 1 1 0 0 0 0 0 0 0 0 0 1 1 0 1 0 0 0  
1 1 1 1 1 0 0 0 1 1 0 0 0 0 0 0 0 0 1 1 0 1 0 0 0  
1 1 1 1 1 1 0 1 1 1 0 0 0 0 0 0 0 0 0 0 0 1 0 0 0  
1 1 0 1 1 1 1 1 1 1 1 0 0 0 0 0 1 0 0 0 0 1 0 0 0  
1 0 0 0 0 0 1 0 0 1 0 0 0 0 0 0 0 0 0 0 0 1 0 1 1  
1 0 0 0 1 0 1 1 1 1 0 0 0 0 1 0 0 0 0 1 1 1 0 1 1  
1 0 0 0 0 0 1 1 1 0 0 0 0 0 0 0 0 0 0 1 1 0 0 0 0  
1 0 0 0 0 0 0 0 0 0 0 0 0 1 1 1 1 1 1 1 0 0 0 0 0  
1 1 0 0 0 0 0 0 0 0 0 0 1 1 0 0 0 0 0 0 0 0 0 0 0  
0 1 1 0 0 0 0 0 0 0 0 1 1 0 0 0 0 0 1 1 0 0 1 0 0  
0 0 1 1 1 1 1 1 1 1 1 1 0 0 0 0 0 0 1 1 0 0 0 0 1  
0 0 0 0 0 0 0 0 0 0 0 0 0 0 0 0 0 0 0 0 0 0 0 0 0  
[DOORTILES]
0 0 0 0 0 0 0 0 0 0 0 0 0 0 0 0 0 0 0 0 0 0 0 0 0  
0 0 0 0 0 0 0 0 0 0 0 0 0 0 0 0 0 0 0 0 0 0 0 0 0 
0 0 0 0 0 0 0 0 0 0 0 0 0 0 0 0 0 0 0 0 0 0 0 0 0 
0 0 0 0 0 0 0 14x1x1 0 0 0 0 0 0 0 0 0 0 0 0 0 0 0 0 0 
0 0 0 0 0 0 0 0 0 0 0 0 0 0 0 0 0 0 0 0 0 0 0 0 0 
0 0 0 0 0 0 0 0 0 0 0 0 0 0 0 0 0 0 0 0 0 0 0 0 0 
0 0 0 0 0 0 0 0 0 0 0 0 0 0 0 15x1x2 0 0 0 0 0 0 0 0 0 
0 0 0 0 0 0 0 0 0 0 0 0 0 0 0 0 0 0 0 0 0 0 0 0 0 
0 0 0 0 0 0 0 0 0 0 0 0 0 0 0 0 0 0 0 0 0 0 0 0 0 
0 0 0 0 0 0 0 0 0 0 0 0 0 0 0 0 0 0 0 0 0 0 0 0 0 
0 0 0 0 0 0 0 0 0 0 0 0 0 0 0 0 0 0 0 0 0 0 0 0 0 
0 0 0 0 0 0 0 0 0 0 0 0 0 0 0 0 0 0 0 0 0 0 0 0 0 
0 0 0 0 0 0 0 0 0 0 0 0 0 0 0 0 0 0 0 0 0 0 0 0 0 
0 0 0 0 0 0 0 0 0 0 0 0 0 0 0 0 0 0 0 0 0 0 0 0 0 
0 0 0 0 0 0 0 0 0 0 0 0 0 0 0 0 0 0 0 0 0 0 0 0 0 
0 0 0 0 0 0 0 0 0 0 0 0 0 0 0 0 0 0 0 0 0 0 0 0 0 
0 0 0 0 0 0 0 0 0 0 0 0 0 0 0 0 0 0 0 0 0 0 0 0 0 
0 0 0 0 0 0 0 0 0 0 0 0 0 0 0 0 0 0 0 0 0 0 0 0 0 
0 0 0 0 0 0 0 0 0 0 0 0 0 0 0 0 0 0 0 0 0 0 0 0 0 
0 0 0 0 0 0 0 0 0 0 0 0 0 0 0 0 0 0 0 0 0 0 0 0 0 
[NEIGHBOURS]
9 9 9 9
[ENEMIES]
[SHOPNPC]
[CIVILIAN]
[ITEMS]