MAP52
[BACKTILES]
45 45 45 45 45 243 39 45 243 148 148 148 148 148 148 45 45 45 45 45 45 239 45 45 45  
45 45 263 264 45 46 55 235 45 68 69 148 48 233 45 45 45 45 45 45 45 45 45 68 69  
45 45 265 266 45 54 48 51 45 70 71 243 236 45 45 227 223 223 223 223 228 45 45 70 71  
45 45 267 268 45 46 51 47 45 14 72 45 45 45 227 219 107 108 125 100 220 228 45 14 72  
45 45 45 45 45 239 45 45 45 45 239 45 45 227 219 249 105 106 104 235 41 220 228 239 45  
45 239 45 45 45 132 133 45 45 45 45 45 45 222 148 45 101 102 103 46 235 40 224 45 45  
44 57 89 45 45 134 135 45 45 45 44 45 44 222 45 45 45 154 45 51 48 235 224 42 40  
48 239 45 45 45 14 72 45 45 227 223 206 223 219 45 232 45 63 45 239 55 47 220 223 223  
244 244 45 45 45 239 45 45 227 219 233 45 45 237 235 45 45 63 45 45 242 45 62 45 45  
45 45 45 45 45 45 45 227 219 233 45 237 45 45 45 45 45 153 58 159 58 58 58 58 58  
45 42 227 223 223 223 223 219 82 54 57 45 43 46 235 239 45 45 45 63 45 45 45 45 45  
45 227 219 148 148 233 45 117 249 139 140 141 241 52 99 53 68 69 45 63 45 217 221 221 221  
45 222 148 121 123 123 76 117 45 142 143 144 241 51 46 53 70 71 45 63 45 224 132 133 233  
45 222 148 121 95 96 124 117 45 145 146 147 45 47 47 242 14 72 45 63 45 224 134 135 45  
243 222 148 77 78 79 80 117 45 45 154 98 45 45 45 45 45 45 45 63 45 224 136 137 45  
45 222 148 233 40 45 45 117 49 49 153 58 159 58 58 58 58 58 58 59 45 224 45 45 45  
45 222 248 248 248 248 120 118 45 45 49 45 63 45 45 43 44 57 45 239 217 225 45 235 45  
239 222 82 91 45 45 45 62 237 45 239 45 63 45 46 55 48 239 45 217 225 45 45 45 45  
42 222 48 45 45 237 45 45 45 239 49 45 63 45 45 47 52 47 45 224 45 45 99 45 235  
148 222 91 45 237 45 45 45 45 45 49 45 63 45 45 45 45 45 45 224 45 239 45 46 50  
[BLOCKTILES]
0 0 0 0 0 0 0 0 0 0 0 0 0 0 0 0 0 0 0 0 0 0 0 0 0  
0 0 1 1 0 0 0 0 0 1 1 0 1 0 0 0 0 0 0 0 0 0 0 1 1  
0 0 1 1 0 0 1 0 0 1 1 0 0 0 0 1 1 1 1 1 1 0 0 1 1  
0 0 0 0 0 0 0 0 0 0 0 0 0 0 1 1 1 1 1 0 1 1 0 0 0  
0 0 0 0 0 0 0 0 0 0 0 0 0 1 1 1 1 1 1 0 0 1 1 0 0  
0 0 0 0 0 1 1 0 0 0 0 0 0 1 0 0 1 0 1 0 0 0 1 0 0  
0 0 0 0 0 1 1 0 0 0 1 1 1 1 0 0 0 0 0 0 1 0 1 0 0  
1 0 0 0 0 0 0 0 0 1 1 0 1 1 0 1 0 0 0 0 0 0 1 1 1  
0 0 0 0 0 0 0 0 1 1 0 0 0 0 0 0 0 0 0 0 0 0 0 0 0  
0 0 0 0 0 0 0 1 1 0 0 0 0 0 0 0 0 0 0 0 0 0 0 0 0  
0 0 1 1 1 1 1 1 1 0 0 0 0 0 0 0 0 0 0 0 0 0 0 0 0  
0 1 1 0 0 0 0 1 1 1 1 1 0 0 1 0 1 1 0 0 0 1 1 1 1  
0 1 0 1 1 1 1 1 0 1 1 1 0 0 0 0 1 1 0 0 0 1 1 1 0  
0 1 0 1 1 1 1 1 0 1 0 1 0 0 0 0 0 0 0 0 0 1 1 1 0  
0 1 0 1 0 0 1 1 0 0 0 1 0 0 0 0 0 0 0 0 0 1 0 0 0  
0 1 0 0 0 0 0 1 0 0 0 0 0 0 0 0 0 0 0 0 0 1 0 0 0  
0 1 1 1 1 1 1 1 0 0 0 0 0 0 0 0 0 0 0 0 1 1 0 0 0  
0 1 1 0 0 0 0 0 0 0 0 0 0 0 0 0 1 0 0 1 1 0 0 0 0  
0 1 1 0 0 0 0 0 0 0 0 0 0 0 0 0 0 0 0 1 0 0 1 0 0  
0 1 0 0 0 0 0 0 0 0 0 0 0 0 0 0 0 0 0 1 0 0 0 0 0  
[DOORTILES]
0 0 0 0 0 0 0 0 0 0 0 0 0 0 0 0 0 0 0 0 0 0 0 0 0  
0 0 0 0 0 0 0 0 0 0 0 0 0 0 0 0 0 0 0 0 0 0 0 0 0 
0 0 0 0 0 0 0 0 0 0 0 0 0 0 0 0 0 0 0 0 0 0 0 0 0 
0 0 0 0 0 0 0 0 0 0 0 0 0 0 0 0 0 0 0 0 0 0 0 0 0 
0 0 0 0 0 0 0 0 0 0 0 0 0 0 0 0 0 0 0 0 0 0 0 0 0 
0 0 0 0 0 0 0 0 0 0 0 0 0 0 0 0 0 0 0 0 0 0 0 0 0 
0 0 0 0 0 0 0 0 0 0 0 0 0 0 0 0 0 0 0 0 0 0 0 0 0 
0 0 0 0 0 0 0 0 0 0 0 7x1x1 0 0 0 0 0 0 0 0 0 0 0 0 0 
0 0 0 0 0 0 0 0 0 0 0 0 0 0 0 0 0 0 0 0 0 0 0 0 0 
0 0 0 0 0 0 0 0 0 0 0 0 0 0 0 0 0 0 0 0 0 0 0 0 0 
0 0 0 0 0 0 0 0 0 0 0 0 0 0 0 0 0 0 0 0 0 0 0 0 0 
0 0 0 0 0 0 0 0 0 0 0 0 0 0 0 0 0 0 0 0 0 0 0 0 0 
0 0 0 0 0 0 0 0 0 0 0 0 0 0 0 0 0 0 0 0 0 0 0 0 0 
0 0 0 0 0 0 0 0 0 0 0 0 0 0 0 0 0 0 0 0 0 0 0 0 0 
0 0 0 0 0 0 0 0 0 0 0 0 0 0 0 0 0 0 0 0 0 0 0 0 0 
0 0 0 0 0 0 0 0 0 0 0 0 0 0 0 0 0 0 0 0 0 0 0 0 0 
0 0 0 0 0 0 0 0 0 0 0 0 0 0 0 0 0 0 0 0 0 0 0 0 0 
0 0 0 0 0 0 0 0 0 0 0 0 0 0 0 0 0 0 0 0 0 0 0 0 0 
0 0 0 0 0 0 0 0 0 0 0 0 0 0 0 0 0 0 0 0 0 0 0 0 0 
0 0 0 0 0 0 0 0 0 0 0 0 0 0 0 0 0 0 0 0 0 0 0 0 0 
[NEIGHBOURS]
4 4 4 4
[ENEMIES]
170 280 Chicken
300 300 Chicken
430 280 Chicken
[SHOPNPC]
[CIVILIAN]
[ITEMS]