5
[BACKTILES]
45 45 45 68 69 45 45 45 45 45 45 45 45 45 45 45 45 45 45 45 45 45 45 45 45  
45 45 45 70 71 45 45 45 45 45 48 45 45 45 45 45 45 45 45 45 45 45 45 45 45  
45 45 45 136 137 39 45 45 45 45 45 45 45 45 45 45 45 45 45 45 45 68 69 45 45  
45 45 45 45 190 186 186 186 186 186 186 186 186 186 186 186 186 186 186 191 45 70 71 45 45  
45 48 39 45 185 148 148 148 40 45 45 45 45 45 45 45 42 148 148 187 45 136 137 45 45  
45 45 45 45 185 148 148 68 69 45 45 45 48 45 45 132 133 40 148 187 45 45 39 45 45  
45 45 45 45 185 148 39 70 71 45 43 39 45 57 45 134 135 45 42 187 45 45 45 48 45  
45 45 45 190 182 39 45 136 137 45 55 126 127 53 45 136 137 45 45 183 186 186 191 45 45  
42 68 69 185 45 45 45 45 45 43 51 128 129 99 45 45 45 45 45 45 45 45 187 45 45  
40 70 71 185 151 45 45 45 45 40 39 130 131 62 45 90 45 45 45 45 45 45 187 45 45  
40 136 137 185 152 45 45 48 45 45 98 149 149 45 45 45 45 45 45 45 45 45 187 45 45  
40 39 39 185 45 45 45 45 45 45 45 154 45 45 45 45 45 48 45 45 45 45 187 45 45  
45 45 39 189 181 45 45 45 45 45 45 153 155 45 45 45 45 45 45 45 45 45 187 45 45  
45 45 45 45 185 45 45 45 45 45 45 45 63 45 45 132 133 45 45 68 69 45 187 45 45  
45 45 45 45 185 45 48 45 41 48 45 45 63 45 45 134 135 45 45 70 71 45 187 45 45  
45 68 69 45 185 45 45 45 45 45 45 45 63 45 45 136 137 45 45 136 137 45 187 45 45  
45 70 71 45 185 45 45 45 45 45 45 45 63 45 45 45 45 45 45 45 45 45 187 45 45  
45 136 137 45 189 184 184 184 184 184 181 45 63 45 180 184 184 184 184 184 184 184 188 45 45  
45 45 45 45 45 45 45 45 45 45 185 45 63 45 187 45 45 45 45 45 45 45 45 45 45  
45 48 45 45 45 45 45 45 45 45 185 45 63 45 187 45 45 45 45 45 48 45 45 45 45  
[BLOCKTILES]
0 0 0 0 0 0 0 0 0 0 0 0 0 0 0 0 0 0 0 0 0 0 0 0 0  
0 0 0 0 0 0 0 0 0 0 0 0 0 0 0 0 0 0 0 0 0 0 0 0 0  
0 0 0 0 0 0 0 0 0 0 0 0 0 0 0 0 0 0 0 0 0 0 0 0 0  
0 0 0 0 1 1 1 1 1 1 1 1 1 1 1 1 1 1 1 1 0 0 0 0 0  
0 0 0 0 1 0 0 0 0 0 0 0 0 0 0 0 0 0 0 1 0 0 0 0 0  
0 0 0 0 1 0 0 1 1 0 0 0 1 0 0 1 1 0 0 1 0 0 0 0 0  
0 0 0 0 1 0 0 1 1 0 0 0 0 0 0 1 1 0 0 1 0 0 0 0 0  
0 0 0 1 1 0 0 0 0 0 0 1 1 0 0 0 0 0 0 1 1 1 1 0 0  
0 0 0 1 0 0 0 0 0 0 0 1 1 1 0 0 0 0 0 0 0 0 1 0 0  
0 0 0 1 1 0 0 0 0 0 0 0 0 0 0 1 0 0 0 0 0 0 1 0 0  
0 0 0 1 1 0 0 1 0 0 1 0 0 0 0 0 0 0 0 0 0 0 1 0 0  
0 0 0 1 0 0 0 0 0 0 0 0 0 0 0 0 0 1 0 0 0 0 1 0 0  
0 0 0 1 1 0 0 0 0 0 0 0 0 0 0 0 0 0 0 0 0 0 1 0 0  
0 0 0 0 1 0 0 0 0 0 0 0 0 0 0 1 1 0 0 1 1 0 1 0 0  
0 0 0 0 1 0 1 0 0 1 0 0 0 0 0 1 1 0 0 1 1 0 1 0 0  
0 0 0 0 1 0 0 0 0 0 0 0 0 0 0 0 0 0 0 0 0 0 1 0 0  
0 0 0 0 1 0 0 0 0 0 0 0 0 0 0 0 0 0 0 0 0 0 1 0 0  
0 0 0 0 1 1 1 1 1 1 1 0 0 0 1 1 1 1 1 1 1 1 1 0 0  
0 0 0 0 0 0 0 0 0 0 1 0 0 0 1 0 0 0 0 0 0 0 0 0 0  
0 0 0 0 0 0 0 0 0 0 1 0 0 0 1 0 0 0 0 0 0 0 0 0 0  
[DOORTILES]
0 0 0 0 0 0 0 0 0 0 0 0 0 0 0 0 0 0 0 0 0 0 0 0 0  
0 0 0 0 0 0 0 0 0 0 0 0 0 0 0 0 0 0 0 0 0 0 0 0 0 
0 0 0 0 0 0 0 0 0 0 0 0 0 0 0 0 0 0 0 0 0 0 0 0 0 
0 0 0 0 0 0 0 0 0 0 0 0 0 0 0 0 0 0 0 0 0 0 0 0 0 
0 0 0 0 0 0 0 0 0 0 0 0 0 0 0 0 0 0 0 0 0 0 0 0 0 
0 0 0 0 0 0 0 0 0 0 0 0 0 0 0 0 0 0 0 0 0 0 0 0 0 
0 0 0 0 0 0 0 0 0 0 0 0 0 0 0 0 0 0 0 0 0 0 0 0 0 
0 0 0 0 0 0 0 0 0 0 0 0 0 0 0 0 0 0 0 0 0 0 0 0 0 
0 0 0 0 0 0 0 0 0 0 0 0 0 0 0 0 0 0 0 0 0 0 0 0 0 
0 0 0 0 0 0 0 0 0 0 0 6x1x2 6x1x1 0 0 0 0 0 0 0 0 0 0 0 0 
0 0 0 0 0 0 0 0 0 0 0 0 0 0 0 0 0 0 0 0 0 0 0 0 0 
0 0 0 0 0 0 0 0 0 0 0 0 0 0 0 0 0 0 0 0 0 0 0 0 0 
0 0 0 0 0 0 0 0 0 0 0 0 0 0 0 0 0 0 0 0 0 0 0 0 0 
0 0 0 0 0 0 0 0 0 0 0 0 0 0 0 0 0 0 0 0 0 0 0 0 0 
0 0 0 0 0 0 0 0 0 0 0 0 0 0 0 0 0 0 0 0 0 0 0 0 0 
0 0 0 0 0 0 0 0 0 0 0 0 0 0 0 0 0 0 0 0 0 0 0 0 0 
0 0 0 0 0 0 0 0 0 0 0 0 0 0 0 0 0 0 0 0 0 0 0 0 0 
0 0 0 0 0 0 0 0 0 0 0 0 0 0 0 0 0 0 0 0 0 0 0 0 0 
0 0 0 0 0 0 0 0 0 0 0 0 0 0 0 0 0 0 0 0 0 0 0 0 0 
0 0 0 0 0 0 0 0 0 0 0 0 0 0 0 0 0 0 0 0 0 0 0 0 0
[NEIGHBOURS]
0 0 0 1
[ENEMIES]
531 230 Chicken
330 430 Chicken
[SHOPNPC]
[CIVILIAN]
[ITEMS]