developmap
[BACKTILES]
45 45 45 45 45 45 45 45 68 69 45 45 68 69 45 45 45 45 45 45 45 45 45 45 45  
45 227 223 223 223 223 228 45 70 71 40 232 70 71 45 45 227 223 223 223 223 223 223 228 45  
45 222 148 148 148 39 220 228 136 137 45 45 136 137 45 227 219 233 45 45 45 45 45 224 45  
45 222 148 99 40 99 41 220 223 223 223 223 223 223 223 219 233 45 43 50 57 45 45 224 45  
45 222 148 45 45 45 45 45 45 45 45 240 45 45 45 45 45 45 55 48 53 45 45 224 45  
45 222 39 99 45 99 45 45 68 69 45 45 45 45 45 42 40 45 41 47 39 240 45 224 45  
42 222 45 45 45 45 45 45 70 71 45 45 45 151 107 108 125 151 45 45 45 45 45 224 45  
223 219 45 45 48 45 45 45 136 137 42 48 45 152 105 106 104 152 132 133 45 45 45 224 45  
45 45 43 44 57 45 45 45 240 263 264 232 45 45 101 102 103 247 134 135 232 247 45 224 45  
58 58 58 58 58 58 230 45 45 265 266 233 45 45 39 254 98 45 136 137 39 45 45 224 45  
45 45 45 45 45 238 63 45 243 267 268 240 45 100 45 154 45 45 45 45 45 42 45 224 45  
221 218 45 45 45 45 63 45 45 45 45 45 45 45 235 63 45 45 240 45 45 48 45 224 39  
40 222 45 48 45 45 153 58 58 58 58 58 58 58 58 59 45 45 45 45 45 45 45 224 45  
42 222 45 45 240 45 45 45 45 45 45 45 45 45 45 45 45 68 69 45 42 45 45 224 45  
45 222 45 45 132 133 45 45 45 45 45 45 45 45 240 45 45 70 71 45 42 148 42 224 45  
45 222 45 45 134 135 45 45 48 45 45 232 45 45 45 45 45 136 137 42 40 148 148 224 45  
45 222 45 45 136 137 45 45 45 235 44 240 45 45 48 45 45 45 45 148 148 148 148 224 45  
45 222 45 240 45 45 45 45 42 148 148 39 42 45 45 45 45 240 45 42 40 148 148 224 45  
232 226 221 221 221 221 221 221 221 221 221 221 221 221 221 221 221 221 221 221 221 221 221 225 45  
45 243 236 236 39 45 236 45 45 45 45 45 45 45 243 39 45 45 45 45 45 232 45 45 45  
[BLOCKTILES]
0 0 0 0 0 0 0 0 0 0 0 0 0 0 0 0 0 0 0 0 0 0 0 0 0  
0 0 0 0 0 0 0 0 0 0 0 0 0 0 0 0 0 0 0 0 0 0 0 0 0  
0 0 0 0 0 0 0 0 0 0 0 0 0 0 0 0 0 0 0 0 0 0 0 0 0  
0 0 0 0 0 0 0 0 0 0 0 0 0 0 0 0 0 0 0 0 0 0 0 0 0  
0 0 0 0 0 0 0 0 0 0 0 0 0 0 0 0 0 0 0 0 0 0 0 0 0  
0 0 0 0 0 0 0 0 0 0 0 0 0 0 0 0 0 0 0 0 0 0 0 0 0  
0 0 0 0 0 0 0 0 0 0 0 0 0 0 0 0 0 0 0 0 0 0 0 0 0  
0 0 0 0 0 0 0 0 0 0 0 0 0 0 0 0 0 0 0 0 0 0 0 0 0  
0 0 0 0 0 0 0 0 0 0 0 0 0 0 0 0 0 0 0 0 0 0 0 0 0  
0 0 0 0 0 0 0 0 0 0 0 0 0 0 0 0 0 0 0 0 0 0 0 0 0  
0 0 0 0 0 0 0 0 0 0 0 0 0 0 0 0 0 0 0 0 0 0 0 0 0  
0 0 0 0 0 0 0 0 0 0 0 0 0 0 0 0 0 0 0 0 0 0 0 0 0  
0 0 0 0 0 0 0 0 0 0 0 0 0 0 0 0 0 0 0 0 0 0 0 0 0  
0 0 0 0 0 0 0 0 0 0 0 0 0 0 0 0 0 0 0 0 0 0 0 0 0  
0 0 0 0 0 0 0 0 0 0 0 0 0 0 0 0 0 0 0 0 0 0 0 0 0  
0 0 0 0 0 0 0 0 0 0 0 0 0 0 0 0 0 0 0 0 0 0 0 0 0  
0 0 0 0 0 0 0 0 0 0 0 0 0 0 0 0 0 0 0 0 0 0 0 0 0  
0 0 0 0 0 0 0 0 0 0 0 0 0 0 0 0 0 0 0 0 0 0 0 0 0  
0 0 0 0 0 0 0 0 0 0 0 0 0 0 0 0 0 0 0 0 0 0 0 0 0  
0 0 0 0 0 0 0 0 0 0 0 0 0 0 0 0 0 0 0 0 0 0 0 0 0  
