newnew0
[BACKTILES]
45 45 45 45 190 186 186 186 186 182 45 45 63 45 45 45 45 45 45 45 45 45 45 45 187  
45 45 45 190 182 45 45 45 45 45 45 45 63 45 45 45 45 45 45 45 45 45 45 45 187  
45 45 190 182 45 45 45 45 45 45 45 45 63 45 99 45 45 45 45 45 45 45 45 45 187  
186 186 182 45 45 45 44 99 45 45 45 45 63 45 45 45 45 45 45 68 69 45 45 45 187  
45 45 45 45 45 50 87 88 88 45 45 45 63 45 45 45 45 45 45 70 71 45 45 45 187  
45 45 45 45 45 55 83 84 85 39 45 45 63 45 45 45 45 45 45 14 72 45 45 45 187  
45 45 68 69 68 69 45 45 154 45 45 45 63 45 89 45 45 45 45 45 45 45 45 45 187  
45 45 70 71 70 71 45 45 63 45 45 45 63 100 45 45 45 45 45 45 99 45 45 45 187  
45 45 14 72 136 137 45 45 63 45 45 45 63 45 45 45 45 45 45 45 68 69 45 45 187  
45 45 45 45 45 45 45 45 153 58 58 159 59 45 45 45 48 45 45 45 70 71 45 45 187  
45 45 45 45 45 45 45 40 45 45 45 63 62 39 45 45 45 45 45 45 14 72 45 45 187  
45 45 48 45 45 45 45 45 45 45 45 63 45 45 45 45 45 45 43 47 57 45 60 45 187  
45 45 45 45 45 45 45 45 45 45 45 63 45 45 45 45 45 45 50 48 52 45 61 45 187  
45 45 45 45 45 45 45 45 45 45 45 63 45 45 45 68 69 45 41 47 39 45 45 45 187  
45 45 45 45 45 45 45 45 45 45 45 63 45 45 45 70 71 45 45 45 45 45 45 45 187  
58 58 58 58 58 58 58 58 58 58 58 59 45 45 45 14 72 45 45 45 45 68 69 45 187  
45 45 45 48 45 45 68 69 45 50 55 53 45 45 45 45 45 45 45 45 45 70 71 45 187  
45 45 45 45 45 45 70 71 45 43 51 40 45 45 45 45 45 45 45 45 45 14 72 45 187  
45 45 45 45 45 45 14 72 45 45 45 45 45 45 45 45 45 45 45 45 45 45 45 45 187  
184 184 184 184 184 184 184 184 184 184 184 184 184 184 184 184 184 184 184 184 184 184 184 184 188  
[BLOCKTILES]
0 0 0 0 1 1 1 1 1 1 0 0 0 0 0 0 0 0 0 0 0 0 0 0 1  
0 0 0 1 1 0 0 0 0 0 0 0 0 0 0 0 0 0 0 0 0 0 0 0 1  
0 0 1 1 0 0 0 0 0 0 0 0 0 0 0 0 0 0 0 0 0 0 0 0 1  
1 1 1 0 0 0 0 1 0 0 0 0 0 0 0 0 0 0 0 1 1 0 0 0 1  
0 0 0 0 0 0 1 1 1 0 0 0 0 0 0 0 0 0 0 1 1 0 0 0 1  
0 0 0 0 0 0 1 0 1 0 0 0 0 0 0 0 0 0 0 0 0 0 0 0 1  
0 0 1 1 1 1 0 0 0 0 0 0 0 0 1 0 0 0 0 0 0 0 0 0 1  
0 0 1 1 1 1 0 0 0 0 0 0 0 0 0 0 0 0 0 0 0 0 0 0 1  
0 0 0 0 0 0 0 0 0 0 0 0 0 0 0 0 0 0 0 0 1 1 0 0 1  
0 0 0 0 0 0 0 0 0 0 0 0 0 0 0 0 1 0 0 0 1 1 0 0 1  
0 0 0 0 0 0 0 0 0 0 0 0 0 0 0 0 0 0 0 0 0 0 0 0 1  
0 0 1 0 0 0 0 0 0 0 0 0 0 0 0 0 0 0 0 0 0 0 1 0 1  
0 0 0 0 0 0 0 0 0 0 0 0 0 0 0 0 0 0 0 1 0 0 0 0 1  
0 0 0 0 0 0 0 0 0 0 0 0 0 0 0 1 1 0 0 0 0 0 0 0 1  
0 0 0 0 0 0 0 0 0 0 0 0 0 0 0 1 1 0 0 0 0 0 0 0 1  
0 0 0 0 0 0 0 0 0 0 0 0 0 0 0 0 0 0 0 0 0 1 1 0 1  
0 0 0 1 0 0 1 1 0 0 0 0 0 0 0 0 0 0 0 0 0 1 1 0 1  
0 0 0 0 0 0 1 1 0 0 0 0 0 0 0 0 0 0 0 0 0 0 0 0 1  
0 0 0 0 0 0 0 0 0 0 0 0 0 0 0 0 0 0 0 0 0 0 0 0 1  
1 1 1 1 1 1 1 1 1 1 1 1 1 1 1 1 1 1 1 1 1 1 1 1 1  
