newnewnew1
[BACKTILES]
45 45 45 45 45 45 45 45 45 45 185 45 63 45 187 45 48 45 45 45 45 45 45 45 45  
186 186 186 186 186 186 186 186 186 186 182 45 63 45 183 186 186 191 45 48 45 45 45 45 45  
113 115 115 115 115 115 115 115 114 45 45 45 63 45 45 45 45 183 191 45 45 45 45 45 45  
150 40 45 45 45 46 55 52 117 45 45 45 153 155 45 45 45 45 183 186 186 186 186 186 186  
150 45 87 88 86 55 60 113 115 115 115 114 45 153 58 155 45 45 45 68 69 45 45 48 45  
150 45 83 84 85 45 61 150 42 100 39 117 45 49 45 63 45 45 45 70 71 45 45 45 45  
150 45 45 63 62 45 40 150 107 108 125 151 49 68 69 63 45 45 45 136 137 45 45 45 45  
116 119 45 63 45 45 41 150 105 106 104 152 45 70 71 63 45 45 43 57 45 45 132 133 45  
181 50 45 63 45 45 45 150 101 102 103 117 49 136 137 63 45 45 46 48 53 45 134 135 45  
185 46 45 63 45 45 45 116 119 63 120 118 49 49 45 63 45 45 57 45 45 45 136 137 45  
185 54 45 153 159 58 58 58 58 59 45 49 68 69 45 63 45 45 45 139 140 141 151 45 45  
185 39 57 45 63 45 44 57 45 45 45 45 70 71 45 63 45 40 45 142 143 144 152 45 45  
185 99 45 45 63 45 89 53 45 45 45 45 136 137 45 63 45 45 39 145 146 147 45 39 45  
185 45 45 45 63 45 45 100 39 45 45 45 45 45 45 63 45 45 45 98 45 45 45 45 45  
185 99 45 45 153 58 58 58 58 58 58 155 45 45 45 153 159 58 58 58 58 58 58 58 58  
185 45 45 45 45 45 45 45 45 45 45 63 45 45 45 45 63 45 45 68 69 45 45 45 45  
185 99 45 99 45 99 45 45 132 133 45 153 58 58 58 58 59 45 45 70 71 45 45 45 45  
185 45 45 45 45 45 45 45 134 135 45 45 45 45 45 48 45 45 45 136 137 45 45 45 45  
185 48 45 45 45 45 45 45 136 137 45 45 45 45 45 45 45 45 45 45 45 45 45 48 45  
189 184 184 184 184 184 184 184 184 184 184 184 184 184 184 184 184 184 184 184 184 184 184 184 184  
[BLOCKTILES]
0 0 0 0 0 0 0 0 0 0 1 0 0 0 1 0 0 0 0 0 0 0 0 0 0  
1 1 1 1 1 1 1 1 1 1 1 0 0 0 1 1 1 1 0 1 0 0 0 0 0  
1 1 1 1 1 1 1 1 1 0 0 0 0 0 0 0 0 1 1 0 0 0 0 0 0  
1 0 0 0 0 0 0 0 1 0 0 0 0 0 0 0 0 0 1 1 1 1 1 1 1  
1 0 1 1 1 0 1 1 1 1 1 1 0 0 0 0 0 0 0 1 1 0 0 1 0  
1 0 1 0 1 0 1 1 0 0 0 1 0 0 0 0 0 0 0 1 1 0 0 0 0  
1 0 0 0 0 0 0 1 1 1 1 1 0 1 1 0 0 0 0 0 0 0 0 0 0  
1 1 0 0 0 0 0 1 1 1 1 1 0 1 1 0 0 0 0 0 0 0 1 1 0  
1 0 0 0 0 0 0 1 1 0 1 1 0 0 0 0 0 0 0 1 0 0 1 1 0  
1 0 0 0 0 0 0 1 1 0 1 1 0 0 0 0 0 0 0 0 0 0 0 0 0  
1 0 0 0 0 0 0 0 0 0 0 0 1 1 0 0 0 0 0 1 1 1 1 0 0  
1 0 0 0 0 0 0 0 0 0 0 0 1 1 0 0 0 0 0 1 1 1 1 0 0  
1 1 0 0 0 0 1 0 0 0 0 0 0 0 0 0 0 0 0 0 0 0 0 0 0  
1 0 0 0 0 0 0 0 0 0 0 0 0 0 0 0 0 0 0 1 0 0 0 0 0  
1 1 0 0 0 0 0 0 0 0 0 0 0 0 0 0 0 0 0 0 0 0 0 0 0  
1 0 0 0 0 0 0 0 0 0 0 0 0 0 0 0 0 0 0 1 1 0 0 0 0  
1 1 0 1 0 1 0 0 1 1 0 0 0 0 0 0 0 0 0 1 1 0 0 0 0  
1 0 0 0 0 0 0 0 1 1 0 0 0 0 0 1 0 0 0 0 0 0 0 0 0  
1 1 0 0 0 0 0 0 0 0 0 0 0 0 0 0 0 0 0 0 0 0 0 1 0  
1 1 1 1 1 1 1 1 1 1 1 1 1 1 1 1 1 1 1 1 1 1 1 1 1  
